1111111111111
1000000000001
1000110000001
1P00100000E01
1111111111111
1000000000001
1000110000C01
1111111111111