1111111111111
10010B0000C01
1000011111001
1P0011E000B01
1111111111111