111111111111111111
1P0000000B00000001
111111110111111101
100000C00000000001
101111111111111001
100000000B0000C001
111111110111111111
1000B00000000000E1
111111111111111111