1111111111111
1C0100B00C001
10001111000C1
1B000000000C1
11111101111C1
1000B00000C01
1C00111000111
10001B00000C1
1P0000C0E0C01
1111111111111